
+---+---+---+---+---+---+---+
| @ | @ @ @ @ @ @ @ |       |
+ @ + @ +---+---+ @ |   +   +
| @ @ @ |       |   |   |   |
+---+---+   +   +   |   +   +
|           |       |   |   |
+   +---+---+---+   +   +
|   |...|...|...|       |   |
+   +...+...+...+---+---+   +
|...|...|...|...|...|       |
+---+---+---+---+---+---+---+
|...|...|...|...|...|...|...|
+---+---+---+---+---+---+---+
|...|...|...|...|...|...|...|
+---+---+---+---+---+---+---+


+---+---+---+---+---+---+---+       +---+---
|...|...|...|...|...|...|...|       |...|...
+---+---+---+---+---+---+---+       +---+---
|...|...|...|...|...|...|...|
+---+---+---+---+---+---+---+
|...|...|...|...|...|...|...|
+---+---+---+---+---+---+---+
|...|...|...|...|...|...|...|
+---+---+---+---+---+---+---+
|...|...|...|...|...|...|...|
+---+---+---+---+---+---+---+
|...|...|...|...|...|...|...|
+---+---+---+---+---+---+---+
|...|...|...|...|...|...|...|
+---+---+---+---+---+---+---+
