
+---+---+---+---+---+---+---+
| @ | @ @ @ @ @ @ @ |       |
+ @ + @ +---+---+ @ |   +   +
| @ @ @ |       |   |   |   |
+---+---+   +   +   |   +   +
|           |       |   |   |
+   +---+---+---+   +   +
|   |...|...|...|       |   |
+   +...+...+...+---+---+   +
|...|...|...|...|...|       |
+---+---+---+---+---+---+---+
|...|...|...|...|...|...|...|
+---+---+---+---+---+---+---+
|...|...|...|...|...|...|...|
+---+---+---+---+---+---+---+


+---+---+---+---+---+---+---+       +---+---
|...|...|...|...|...|...|...|       |...|...
+---+---+---+---+---+---+---+       +---+---
|...|...|...|...|...|...|...|
+---+---+---+---+---+---+---+
|...|...|...|...|...|...|...|
+---+---+---+---+---+---+---+
|...|...|...|...|...|...|...|
+---+---+---+---+---+---+---+
|...|...|...|...|...|...|...|
+---+---+---+---+---+---+---+
|...|...|...|...|...|...|...|
+---+---+---+---+---+---+---+
|...|...|...|...|...|...|...|
+---+---+---+---+---+---+---+


+--x---------+
|.|.||||||||||
|...||||||||||
||||||||||||||
||||||||||||||
||||||||||||||
||||||||||||||
|   | ||||||||
| ||| ||||||||
|     ||||||||
+---------x--+

+-----+
|.|...|
|.|.|.|
|...|.|
+-----+